1111111111
10001100E1
100CCCC001
1P00110001
1111111111
