11111111111111111111111
1C010000000E00000000001
10010000000000000000001
10010000000000000000001
10010000000000000000001
100000000C0000000100001
10010000000000001110001
10011100000000000100001
10000100000000000000001
1111010000000000000001
1P000100000000000000001
11111111111111111111111
