11111111111111111111111
10000000000E0v00vvv0001
10000000000000000000001
10010000000000000000001
10010000000000000000001
100v00000C0000000100001
10010000000000001110001
10010000000000000100001
10000000000000000000001
10000000000000000000001
1P0000000000^0^^^^^^^^1
11111111111111111111111
