11111111111111111111111
10000000000E00000000001
10000000000000000000001
10000000000000000000001
10000000000000000000001
100000000C0000000100001
10000000000000001110001
10000000000000000100001
10000000000000000000001
10000000000000000000001
10000000000P^0000000001
11111111111111111111111
