11111111111111111111111
1000000v000E00000000001
10000000000000000000001
10010000000000000000001
10010000000000000000001
100v00000C0000000100001
10010000000000001110001
1001000^000000000100001
10000000000000000000001
10000000000000000000001
1P000000000000000000001
11111111111111111111111
