1111111111
10000000E1
1000000001
1000000001
100CCCC001
1000000001
1000A00001
1000000001
1000000001
1P00000001
1111111111
